######
#.$  #
#.$$@#
#.   #
######

######
# $ .#
#.$ $#
#   @#
#   .#
######

#######
#     #
#     #
#. #  #
#. $$ #
#.$$  #
#.#  @#
#######

    ######
    ##   #
    ##$  #
  ####  $##
  ##  $ $ #
#### # ## #   ######
##   # ## #####  ..#
## $  $          ..#
###### ### #@##  ..#
    ##     #########
    ########